11111111111111111111
200N01111007000Z0001
11Q6111110M000066601
1001011110M660000001
1000010010M5L1100001
1000011110M001100501
1000511*10700110H001
100MMM00011000010001
10061100000001100661
10000007700001100003
1000000000CC01100001
11111110011111111111

11111111111111111111
20000000001111111111
10000000001111111111
10000000001111111111
10000000000000060C01
10000000000000060003
10000000000000060001
10000G00000000060701
11111111100000060001
11111111100000060L01
1111111110000000O111
11111111111111111111

11111111111111111111
20011111111111111111
10000500111111111111
111100000000M1111111
1111?L00050000G11111
111111Z0000000C11111
11111111Z0000000K111
11111100500500501111
11111111111O61111111
11467070707070701111
10000801111111100!11
1111111111111111S111

