11111111111111111111
20ZZ01KT100Z00000001
10066110100000100001
10N00100100660000001
10M00105100501100001
10000101100501100001
1000010010010110LL01
10000110100001100001
10000000000001100001
10C00105010001100103
S0C0K000000C51100001
11111111111111111111

1111111111000001101?
20000000000100000000
10000111111101011001
10011006661111111111
10010000000000000101
10100K00050500000003
10100000050500001101
10100000000000000111
10011111100000000111
11011111100000000001
110500111111100000!1
11111000000001111111

111111111111111111?1
20010000010000000001
10000010100100111111
10000101600101065001
100100000011100!0051
11111111111001505101
105000050O0001061001
10000000010000011001
10000000010001111001
4060500011001K500011
10050005111001110001
11111111G00011111111