11111111111111111111
20000111100000000001
10N60111100000000001
10000111100660000001
10000111100001100501
1006711110Z001100001
10000111100001100001
10000111100001100001
10060000000001107001
10000700000001100003
1000000CCC0001105001
11111111111111111111

11111111111111111111
20000000001111111111
10000000001111111111
10000706661111111111
1Z0007000000H0000001
10000700000500070003
10000700000000000CC1
10000700000000070001
11111111100600000001
11111111100000000001
11111111100007000001
11111111111111111111

11111111111111111111
200ZHL00000000000001
10000000000000000001
1CCCK000070000070001
16666660000000000001
16666660000000000001
16666660000900070001
10000000000000000001
10000000000000000001
40600000070000007001
10000000000000000001
11111111111111111111