11111111111111111111
20N011KM100Z00500111
10001100100000100001
1Q111100100000005001
10MMM105100501100511
10MMM101100001100001
10500100101101100L01
1C0M0110100161100001
11000R00000001150051
11100105000001100003
111111111#111111M011
111111111T1111111111

1111111111000011101?
200005MMMMM100MMM000
10000111111101511501
10011006661111111111
10010000000000000101
101MMM0K050500H00003
101MMM06050500001101
101S0000000090000111
10011111100000500111
11Z11111100R00000001
11050K111111100000!1
11111000000001111111

111111111111111111?1
20010500010500005001
10R00010100150111111
10000101000101065001
1L0105005011100!0051
111111111110015051M1
107000070O00010610M1
1770700001MMM00110M1
1070700001MMM11110M1
4700700011001K500011
10700007111001110001
11111111G00011111111

