11N1111171111K111111
20011711!111C0Z11111
1101151LGRO?07000011
11Q11711M11100011011
11M11511111110111011
11M11711100005111011
11M11511101111511711
11M11711101111111511
11M11511100111011711
110110511600#0T01511
00000000007011011711
11111111111111111311

11111111111111111111
2MMMM6MM6MM600011111
1MM6MM6MMMM6MM111111
1MM6MM6MM6MM6MM11111
16MM6MM6MM6MM6MM1111
1M6MM6MM6MM6MM6MM111
1116L00000000Z111111
1R550705050505050511
11111111100050505011
11111111370505050501
111111111S0005050011
11111111111111111111

11111111111111111111
2070700000000000G701
111L0000C00007007011
111100R70K000Z0L1111
1111111111O111111111
11111110000001111111
10007000000000070001
11006060090006006011
111Z6006700060060111
1111160600070L111111
11111111114111111111
11111111111111111111

