11111111111111111111
20ZZ01KT100Z00000001
10066110100000100001
10000100100660000001
10M00105100501100001
10000101100501100001
1000010010010110LL01
10000110100001100001
10000000000001100001
10T00105010001100103
10T0K000000051100001
11111111111111111111

1111111111000001101?
20000000000100000000
10000111111101011001
10011006661111111111
10010000000000000101
10100K00050500000103
10100000050500001101
10100000000000000111
10011111100000000111
11011111100000000001
110500111111100000!1
11111000000001111111

11111111111111111111
20000000000000000001
10000000000000000001
10000000060000060001
10000000000000000001
11111111111000000001
10000000000000060001
10000000000000000001
10000000000000000001
40600000000000000001
10000000000000000001
11111111111111111111