11111111111111111111
20ZZ0111100Z00000001
10066111100000500001
10000111100660000001
10M00111100501100001
10000111100501100001
10000111100501105L01
10000111100001100001
1K0H000H000001100001
10T00505050001100503
10T0K000000001100001
11111111111111111111

11111111111111111111
20000000001111111111
10000000001111111111
10000706661111111111
10000700000000000001
10000800000000000003
10000700000000000001
10000700000000000001
11111111100000000001
11111111100000000001
11111111100000000001
11111111111111111111

11111111111111111111
20000000000000000001
10000000000000000001
10000000060000060001
10000000000000000001
11111111111000000001
10000000000000060001
10000000000000000001
10000000000000000001
40600000000000000001
10000000000000000001
11111111111111111111