11111111111111111111
20000111100000000001
10N60111100000000001
10000111100660000001
10000111100001100001
10000111100001100001
10000111100001100001
10000111100001100001
10060000000001100001
10000000000001100003
10000000000001100001
11111111111111111111

11111111111111111111
20000000001111111111
10000000001111111111
10000706661111111111
10000700000000000001
10000700000000000003
10000700000000000001
10000700000000000001
11111111100000000001
11111111100000000001
11111111100000000001
11111111111111111111

11111111111111111111
20000000000000000001
10000000000000000001
10000000070000070001
16666660000000000001
16666660000000000001
16666660000900070001
10000000000000000001
10000000000000000001
40600000070000007001
10000000000000000001
11111111111111111111