11111111111111111111
200N01111007000Z0001
1006011110M000066601
1000011110M660000001
1000010010M501100001
1000011110M001100501
1000511110700110H001
100MMM00011000010001
10061100000001100661
10000007700001100003
1000000000CC01100001
11111110011111111111

11111111111111111111
20000000001111111111
10000000001111111111
100007M6661111111111
10000700000000000661
10500700000000600603
10500700000005600601
10000700000000600601
11111111100005600601
11111111100000600601
11111111100000600001
11111111111111111111

11111111111111111111
20000000000000000001
10000000000000000001
10000000070000070001
10000000000000000001
10000000000000000001
10000000080000070001
10000000000000000001
10000000000000000001
40600000070000070001
10000000000000000001
11111111111111111111