11111111111111111111
20N011KT100Z00500111
10051100100000100001
10111100100000005001
10M00105100501100511
10000101100001100001
10500100101101100L01
1C000110100161100001
11000000000001170071
11100105010001100103
1111111111111111M001
11111111111111111111

1111111111000011101?
20000000000100000000
10000111111101011001
10011006661111111111
10010000000000000101
10100K00050500000003
10100000050500001101
101S0000000000000111
10011111100000000111
11011111100000000001
11050K111111100000!1
11111000000001111111

111111111111111111?1
20010500010500055001
10000515100150111111
10000151070101065001
1L0155555011100!0051
11111111111001505101
105000050O0001061001
10000000010000011001
10700000010001111001
4800000011001K500011
10700005111001110001
11111111G00011111111